1;..!!......................................**xx**;7;0;0;0;0;0
2;..!!..........**.....................*..*.**xx**;11;0;0;0;0;0
3;!....!........*...***...........*..*xx*..****..*;13;0;0;0;0;0
4;..!!....**.........*..*..*..*..*..*.*....**x**x*;15;0;0;0;0;0
5;!!...*.....*..*..****..**....**.*..*..*..*x.*.x*;15;0;0;0;0;0
6;!....***...*.!.*.*.*.***.*...***.*.**x.*x*******;11;0;0;0;0;0
7;!......*.**..*...*****.x.!..!..*..*.*....**x**x*;13;0;0;0;0;0
8;!*.**!.***....*.......*..*..****....x..**.*.***x;16;0;0;0;0;0
9;!....!*....**....**.**.**.**.*.......*..*.**xx**;12;0;0;0;0;0
10;!*..*!..**..*....**.*...***.*...***.x.....**x**.;19;0;0;0;0;0
11;!*!!*!.*..*..*..*........*..*..**.*...*.*.x.xx*x;17;0;0;0;0;0
12;!.......**.*...*.!*x*...!.*.*.*.*x**.....!.*x*x*;7;0;0;0;0;0
13;.!!!!.*.*.x**.*****.....*.*.*x***...*x..*x******;18;0;0;0;0;0
14;!....!*.*.***.***!x.....x.***x******..!!..x*..*x;14;0;0;0;0;0
15;...!!!.**.*x...***.*....**..*x!*.***.......***xx;24;0;0;0;0;0
16;..!.!!.*x*....*****.......*.*..**x**x*!..***.*x*;24;0;0;0;0;0
17;!.*..!..-...***.......*.o...***..*.!...-..xxx**.;22;0;0;0;0;0
18;**!!**......**..*|!.**....*....o-..*|**..xxx...*;19;0;0;0;0;0
19;!o...***.*.*.*.*.o.***=*!.....**.*.*...***x*...x;21;0;0;0;0;0
20;!!!!!!.*........*..*..x..x..*..***......xx.xx.**;15;0;0;0;0;0
21;!..****!..**.|!..*..|!..x*.|!.**..|o....*.xxxx**;12;0;0;0;0;0
22;!.=...!.*.*....**o.*.=..|***|*.......*..*..*xx*.;17;0;0;0;0;0
23;*!**!*o.....*.**.***.*|*x....x!....!.*..*.**xx**;20;0;0;0;0;0
24;.!..!.**..**!*...*...*...*..****...xx..*.**..*.x;18;0;0;0;0;0
25;.....!x*...*!.....*...*x.....!x*...*!.....*...*x;12;0;0;0;0;0
26;!....!..**..*o**o*!....!.*..*..*..*o*----|*xxxx*;15;0;0;0;0;0
27;.!..!..*..*..*..*..............*..*..****.x.**.x;15;0;0;0;0;0
28;!......*..!.*..*...!..**..*..x-*...*.|...xx|...o;31;0;0;0;0;0
29;..!!...*..*..****......!.*..*..*..*.x*!.*xx....x;16;0;0;0;0;0
30;!!**!!*----*!x...!.x..x.....x**.......*.*.ox*.*x;21;0;0;0;0;0
31;!......*.!...*..*.*...*x..*..!.o*.*|.**.*|x...*x;13;0;0;0;0;0
32;!!....--***o.....x.*....*..*.x!...**..*...**x.**;17;0;0;0;0;0
33;x!...o....*****...!...*.!.....*-**-*.......*xx*.;16;0;0;0;0;0
34;..!!.!.*o**....**....***.*....o*..**x*..-x**.x**;13;0;0;0;0;0
35;!............*!!*.o.!!**x**-*........x*-x..xx.*.;15;0;0;0;0;0
36;!....o.*!!*..*--*.x|........*..*.**.**..**x....x;20;0;0;0;0;0
37;*******!*!*!*---*o...*...*.x*o.*-*o.**..*ox|..*x;13;0;0;0;0;0
38;!....!.*.x**.x*..!!...*..*..x**x.*!..!...x*.*.x*;14;0;0;0;0;0
39;..!|.!!..*...*.*.***-*.**....x...*...*..*..*xxo.;23;0;0;0;0;0
40;*....!*..*.*!..***.*.*!o**.*.o...**-.*..|.xx.*x*;17;0;0;0;0;0
41;!!!...!!....!.**....**..*.**.**.xx.**.xx.**.xx.*;14;0;0;0;0;0
42;!*!!*!.*........*..**.*.**x.*.*...x*......x*..*x;19;0;0;0;0;0
43;!.oo.!-!**!-o-!!-o|o--o|*|oo|***||**x.oo.x*xxxx*;20;0;0;0;0;0
44;*!...!*.*.*!*.*..!***.*.x...**.....x.*.*.*x*.x**;18;0;0;0;0;0
45;*..!!!*.!!...*..*..|..*.x.*..*x.*...x..*..x..*ox;26;0;0;0;0;0
46;!...**.*..|x*....***!..x!*.*...**!....*.*.oxx--.;13;0;0;0;0;0
47;!.**.!*.!!.*.......**.*.*x..x*.......*..*.x*..*x;17;0;0;0;0;0
48;!!!!!!..*.*..*..*.-*.**-......*.*.*o......xxxxxx;21;0;0;0;0;0
49;.!!.....*.*...*.!****..!....**..*.....*.xxxx*.**;15;0;0;0;0;0
50;!!..!!!o..o!-o--o-......*.**.****x-x......xx..xx;23;0;0;0;0;0
51;!!....!..**o**-**........*..*.***=**.......xxx..;23;0;0;0;0;0
52;!.*.!...*.....*.*.*.|..*o.|.....**..****..x..|.x;18;0;0;0;0;0
53;..!!...*..*..**...*....*....**..*...**..*.x...x*;14;0;0;0;0;0
54;.!..!..*.*..**.***.....*...*.!****.*......xxx*..;23;0;0;0;0;0
55;*!!...*....*...*.*.*.*.*.*.*.*.*.*-*..**.xx....o;26;0;0;0;0;0
56;!....!.*..*..*..*..*..***!...*..*..x**..**x....x;17;0;0;0;0;0
57;!*.!!.!=..*..*..**.*...o.*.**..*..xx.*.....=..xx;15;0;0;0;0;0
58;*!..!**.*..****-**.....!*.*.*.*o*.**.........xxx;20;0;0;0;0;0
59;!....!.*..*.**==**....o!..*.*...***-*.....**oxxx;25;0;0;0;0;0
60;!!..!!.**...*...*-...|...*.*.*.**x.*..o*..**x*xx;25;0;0;0;0;0
61;!!..!!.*..*.....*..*...*.*....*..*..x..*.x*xx***;17;0;0;0;0;0
62;.!..!.*.**.*...***.*.|.x.o*****.!..!x.*.*.x.*.*x;18;0;0;0;0;0
63;.!!!!..****.o*x.|..*...ox*.*......**.**o...#xx*.;20;0;0;0;0;0
64;!*....!!*...!!o|o....**=x*x...x.|...x..*.*x..*.*;22;0;0;0;0;0
65;*!..!*..*...o.****..o.x*.***.!.*.*.!.|.|..x*x*.x;15;0;0;0;0;0
66;*!........!***..**o....!..**..**....**-**.xo..xx;24;0;0;0;0;0
67;*.!!.**....***..**.*..*....**..*....**.*.xx..***;14;0;0;0;0;0
68;.o!!o.*-**-*!....!.*..*.*x..x*.......*..*..x**x.;23;0;0;0;0;0
69;!#!!#!.*..*..*o.*..**.*..*..*..*..**x*..--x|.|xx;18;0;0;0;0;0
70;!!..!!..**..****-*!.....**.*..o..***x....xx.*x.x;32;0;0;0;0;0
71;!!.......**.****..!......*.*.*x*.*****...x...*.x;24;0;0;0;0;0
72;.!..!..*..*..o**........**-**....*x..*.***.*...x;19;0;0;0;0;0
73;!...!..*...**.!.*!..*...x.*.*.*..*x......*x*.*.x;22;0;0;0;0;0
74;*o!o.*=!=!=!o!!!!o*----*......x-**-xx....xx-xx-x;20;0;0;0;0;0
75;*!..!***..***....**.**.**....***..***....**x**x*;14;0;0;0;0;0
76;*!!!*|..*..|*...*|o.*..|*...*|..*..|*...*|x.*x.x;14;0;0;0;0;0
77;!!|..!!!|..x!!|...--*.x.....xx.x...o.*.x.x******;17;0;0;0;0;0
78;.!!.!!.*.**..****.......o...****..#xx|..#xx|..**;26;0;0;0;0;0
79;*!o***.*!.**o.-!.**..*!.x=..-!..*..*x..=..x.xx*.;14;0;0;0;0;0
80;..!!!..*.**..**....*..*.o*..*x-....*..**--x.**.x;17;0;0;0;0;0
81;!*!.*--*..*!!*..x--*o.*!-**.*--#.o*-.*.**xxx..|x;21;0;0;0;0;0
82;!!....!!..*.***.**......*.*.*.x.*****....xx.**.x;30;0;0;0;0;0
83;.!!!!.o.**.o*....*......*-**=*......|....|xx**xx;21;0;0;0;0;0
84;!...!!....****...!x..*.....**o..|..x.**..x***..x;20;0;0;0;0;0
85;!....!*o...****.**-*....***.*.....*...*...xx*...;17;0;0;0;0;0
86;!!..!*.....!.**.*.*....*x....x........**..*.xx.*;18;0;0;0;0;0
87;.o#.!x******!.#.....*..x******!..#.x******x..|.!;13;0;0;0;0;0
88;!!!!!!.o..o..x..x..x..x...!!....!!..-x..x-.xxxx.;12;0;0;0;0;0
89;!!...o!!...*....**....=||x..*||*..*|.**x*o.x**x.;19;0;0;0;0;0
90;..!**...***..**!|.....*..*x.*.**..*.!..o*xx*.***;15;0;0;0;0;0
91;*!!!!*.*o.*..*..*..*.o*..*--*..#..#...xx..x*..*x;16;0;0;0;0;0
92;!..*...*...x*..!.*!*.*.*!..***.*....x...*.x...*x;15;0;0;0;0;0
93;o..!|!=**.*-o|!|...*-*...*x*...*****.|...x.|...x;17;0;0;0;0;0
94;!.!.!|.o.**.--*.....*...*x*.*.....**x.*!|x..*..x;19;0;0;0;0;0
95;!o.o..*****x!..|.x******!|.#..****.xx.#.|!!.#..x;15;0;0;0;0;0
96;!!....*oooo*............==**==.......*--*..|xx|.;19;0;0;0;0;0
97;.!xx!.......!!!!!!.x..x.xx..xx!!....--*...x.|.xo;14;0;0;0;0;0
98;!!..*****.!!*....!*.**..*...**x.*..xx.*..*x.*..x;28;0;0;0;0;0
99;!!..!!..*.....*.*..*..**.*....x*..*x......xx!!xx;18;0;0;0;0;0
100;!!.......*..****..!....*.*.*.*.*..****...xx..*.x;23;0;0;0;0;0
101;*.!.....*..!.*x.*!....*.*..*...-*.....x*.*.*x..o;16;0;0;0;0;0
102;!......*...!.*.*..**.***.......*..*..*..*..x**x.;22;0;0;0;0;0
103;*!..#..|!!|..|!!|..****.....x..*..x..*..xo.x*..x;25;0;0;0;0;0
104;!.......!!*o.*..*--*.*....x*..*....*...*..x*.*.x;21;0;0;0;0;0
105;!.....**--*.x...!*****x*!...#.*****xx.o#.!..=...;17;0;0;0;0;0
106;o...!xx!.|.o!...x..x...!!..|xo!...#..!|.x.!...xx;19;0;0;0;0;0
107;!......*.*..*..*..*.*..**.*...*...*..***..x....*;17;0;0;0;0;0
108;.|..!!.*..!!x*..*.....*.....x...*...x**...x....o;19;0;0;0;0;0
109;..!!...*..*...**!.x..*!....*..*.....x.*.*.x.*.x*;16;0;0;0;0;0
110;!.!!.!*.**.*..*....*x.*..*...*.*x.......*.x...*x;21;0;0;0;0;0
111;!.....!.*..x.*!........*..*.x*.*......*..x*....*;12;0;0;0;0;0
112;.!!!!!...*....*....*.o*...*x..======..xx....xx..;16;0;0;0;0;0
113;!.*!.....*..**...*.*--*!o.==..x*..*x*....*...*.x;21;0;0;0;0;0
114;!......**.*.*...*-!***.....o..*x.*...**...x.#.*.;16;0;0;0;0;0
115;.....!.*.*..*...**..*..|!.*--x*.*..**....**x..o*;16;0;0;0;0;0
116;!....!.*..*o**.......**..*..*.--**-=*.xx.*--**--;25;0;0;0;0;0
117;*!*****.....*....o*x**.*!.****..|**!.*....**xx*.;16;0;0;0;0;0
118;*!**!*........**...*!.*..*....o*--*.=x..**x...ox;17;0;0;0;0;0
119;!!......*.*..*..*..*.*..*..*.*..*..*x.*..***...x;16;0;0;0;0;0
120;!.!!*!.*|**.x*!.*.**....x...*o**#**x!.....**.xxx;19;0;0;0;0;0
