!....!
*....*
*....*
*.**.*
*.**.*
......
.*..*.
**xx**
12
