*o!o.*
=!=!=!
o!!!!o
*----*
......
x-**-x
x....x
x-xx-x
20
