*!**!*
o.....
*.**.*
**.*|*
x....x
!....!
.*..*.
**xx**
20
