*!..!*
**..**
*....*
*.**.*
*....*
**..**
*....*
*x**x*
14
